1111111111111111111111
1010001011101110101111
1010101111111111111011
1000000111111111111111
1011101011111011111011
1111111011101011111011
1000111011111011111011
1010101011111111101011
1110111010001011111011
1000C00C101010000000E1
1111111111111111111111
